a cake was burned	burn ( theme = cake )
the box was eaten	eat ( theme = * box )
Emma smiled	smile ( agent = Emma )
the cookie was lent to Aiden	lend ( theme = * cookie , recipient = Aiden )
the dog poked the cake	poke ( agent = * dog , theme = * cake )
the boy rolled	roll ( theme = * boy )
a cake was given to Emma	give ( theme = cake , recipient = Emma )
a penny was grown by a child	grow ( theme = penny , agent = child )
a pony rolled the crayon in the cot	roll ( agent = pony , theme = * crayon ( nmod . in = * cot ) )
Ryan knew a cake	know ( agent = Ryan , theme = cake )
a dog cleaned	clean ( agent = dog )
a rose was pierced by a girl	pierce ( theme = rose , agent = girl )
Abigail returned a duck the cake	return ( agent = Abigail , recipient = duck , theme = * cake )
the cake was eaten by Liam	eat ( theme = * cake , agent = Liam )
a frog wanted to smirk	want ( agent = frog , xcomp = smirk ( agent = frog ) )
a bat was enlarged	enlarge ( theme = bat )
the raisin was sketched	sketch ( theme = * raisin )
Noah was lent a fruit on a table by Emma	lend ( recipient = Noah , theme = fruit ( nmod . on = table ) , agent = Emma )
the cat was sent the hammer beside a table by a girl	send ( recipient = * cat , theme = * hammer ( nmod . beside = table ) , agent = girl )
the cake was grown	grow ( theme = * cake )
a girl was given the cookie beside the toy	give ( recipient = girl , theme = * cookie ( nmod . beside = * toy ) )
Emma floated a pillow	float ( agent = Emma , theme = pillow )
a pizza was reddened by Isabella	redden ( theme = pizza , agent = Isabella )
the cake was sold to Emma	sell ( theme = * cake , recipient = Emma )
the can was collapsed	collapse ( theme = * can )
the girl ate	eat ( agent = * girl )
a bear noticed that the girl appreciated a boy	notice ( agent = bear , ccomp = appreciate ( agent = * girl , theme = boy ) )
a boy noticed that the cake was eaten by Noah	notice ( agent = boy , ccomp = eat ( theme = * cake , agent = Noah ) )
the box was liked by the girl	like ( theme = * box , agent = * girl )
the dog painted	paint ( agent = * dog )
the rose was painted	paint ( theme = * rose )
Ava returned Mason the sandwich in the box	return ( agent = Ava , recipient = Mason , theme = * sandwich ( nmod . in = * box ) )
Emma was loaned the donut beside the table by the boy	loan ( recipient = Emma , theme = * donut ( nmod . beside = * table ) , agent = * boy )
the girl gave the raisin to the buyer	give ( agent = * girl , theme = * raisin , recipient = * buyer )
a girl sent Olivia the box in a house	send ( agent = girl , recipient = Olivia , theme = * box ( nmod . in = house ) )
the girl believed that the cake was brought to a boy by the customer	believe ( agent = * girl , ccomp = bring ( theme = * cake , recipient = boy , agent = * customer ) )
a girl dusted Emma	dust ( agent = girl , theme = Emma )
Sophia was sent the cake by a teacher	send ( recipient = Sophia , theme = * cake , agent = teacher )
a boy slept	sleep ( agent = boy )
Emma sold a girl a cake in a car	sell ( agent = Emma , recipient = girl , theme = cake ( nmod . in = car ) )
Emma brought Liam a cake	bring ( agent = Emma , recipient = Liam , theme = cake )
Chloe slept	sleep ( agent = Chloe )
Avery slid Riley	slide ( agent = Avery , theme = Riley )
a cake was lent to Emma by a girl	lend ( theme = cake , recipient = Emma , agent = girl )
the potato was liked by William	like ( theme = * potato , agent = William )
a cake was rented to a boy	rent ( theme = cake , recipient = boy )
the cake was rolled	roll ( theme = * cake )
Lily painted	paint ( agent = Lily )
the cat was given a sandwich by a bird	give ( recipient = * cat , theme = sandwich , agent = bird )
Noah attempted to run	attempt ( agent = Noah , xcomp = run ( agent = Noah ) )
a girl adored the cat	adore ( agent = girl , theme = * cat )
Liam wanted to dance	want ( agent = Liam , xcomp = dance ( agent = Liam ) )
a dog gave Emma the cake	give ( agent = dog , recipient = Emma , theme = * cake )
a drink was tossed	toss ( theme = drink )
a bucket was promised to the boy	promise ( theme = bucket , recipient = * boy )
Liam rolled	roll ( theme = Liam )
the cat admired that a cake was rolled by the girl	admire ( agent = * cat , ccomp = roll ( theme = cake , agent = * girl ) )
a girl smiled	smile ( agent = girl )
Isabella was offered the cake	offer ( recipient = Isabella , theme = * cake )
a cake was eaten by a girl	eat ( theme = cake , agent = girl )
Emma sold the toy in the cabinet to a girl	sell ( agent = Emma , theme = * toy ( nmod . in = * cabinet ) , recipient = girl )
Carter was given the flower	give ( recipient = Carter , theme = * flower )
Liam drew	draw ( agent = Liam )
Amelia painted	paint ( agent = Amelia )
the girl crumpled Emma	crumple ( agent = * girl , theme = Emma )
a cake crumpled	crumple ( theme = cake )
Emma rolled	roll ( theme = Emma )
a girl valued the crayon	value ( agent = girl , theme = * crayon )
the jacket was given to a girl	give ( theme = * jacket , recipient = girl )
Emma hoped that the donut was inflated by a monkey	hope ( agent = Emma , ccomp = inflate ( theme = * donut , agent = monkey ) )
the rose was appreciated by a baby	appreciate ( theme = * rose , agent = baby )
a donut was heard	hear ( theme = donut )
the boy froze	freeze ( theme = * boy )
the cake was eaten	eat ( theme = * cake )
the raisin was passed to Mateo by Amelia	pass ( theme = * raisin , recipient = Mateo , agent = Amelia )
the melon was rolled by a coach	roll ( theme = * melon , agent = coach )
the girl froze a box	freeze ( agent = * girl , theme = box )
Emma mailed a girl a sweetcorn in a car	mail ( agent = Emma , recipient = girl , theme = sweetcorn ( nmod . in = car ) )
a chicken said that a pupil loaned a cake to Emma	say ( agent = chicken , ccomp = loan ( agent = pupil , theme = cake , recipient = Emma ) )
Emma loaned Lincoln a cake	loan ( agent = Emma , recipient = Lincoln , theme = cake )
the present rolled	roll ( theme = * present )
a passenger was given a cake on a stack by Michael	give ( recipient = passenger , theme = cake ( nmod . on = stack ) , agent = Michael )
Emma ran	run ( agent = Emma )
a ball was snapped	snap ( theme = ball )
Olivia gave a cake on the table to Emma	give ( agent = Olivia , theme = cake ( nmod . on = * table ) , recipient = Emma )
the cookie was found by Ellie	find ( theme = * cookie , agent = Ellie )
the cake was shortened	shorten ( theme = * cake )
a girl was passed a cake by Hannah	pass ( recipient = girl , theme = cake , agent = Hannah )
a donut was eaten	eat ( theme = donut )
a sheep painted the pizza	paint ( agent = sheep , theme = * pizza )
a cake split	split ( theme = cake )
Isabella wished that a bowl was offered to a researcher by Grayson	wish ( agent = Isabella , ccomp = offer ( theme = bowl , recipient = researcher , agent = Grayson ) )
a cake was rolled	roll ( theme = cake )
a melon was rolled by a farmer	roll ( theme = melon , agent = farmer )
a teacher was given a pickle in a storage beside a chair	give ( recipient = teacher , theme = pickle ( nmod . in = storage ( nmod . beside = chair ) ) )
the cat was lent a cake beside the table by a boy	lend ( recipient = * cat , theme = cake ( nmod . beside = * table ) , agent = boy )
Liam slept	sleep ( agent = Liam )
Matthew was served a ball on the floor	serve ( recipient = Matthew , theme = ball ( nmod . on = * floor ) )
Emma was sold the raisin in a storage	sell ( recipient = Emma , theme = * raisin ( nmod . in = storage ) )
a girl slept	sleep ( agent = girl )
the girl ate the toy	eat ( agent = * girl , theme = * toy )
a boy was lent the block on a piano	lend ( recipient = boy , theme = * block ( nmod . on = piano ) )
a cookie was eaten	eat ( theme = cookie )
the girl was sent the cake beside the road	send ( recipient = * girl , theme = * cake ( nmod . beside = * road ) )
a cookie was shortened by the boy	shorten ( theme = cookie , agent = * boy )
a melon was packed	pack ( theme = melon )
Emma ate	eat ( agent = Emma )
the girl rolled the muffin	roll ( agent = * girl , theme = * muffin )
a cloud was snapped by a girl	snap ( theme = cloud , agent = girl )
the girl hoped that Emma gave a cake beside a table to the cat	hope ( agent = * girl , ccomp = give ( agent = Emma , theme = cake ( nmod . beside = table ) , recipient = * cat ) )
Emma was given a cake beside a table	give ( recipient = Emma , theme = cake ( nmod . beside = table ) )
a girl liked that the cake was slid	like ( agent = girl , ccomp = slide ( theme = * cake ) )
Emma posted the box to a boy	post ( agent = Emma , theme = * box , recipient = boy )
Olivia was sent a cake	send ( recipient = Olivia , theme = cake )
a passenger rolled the present	roll ( agent = passenger , theme = * present )
Benjamin wanted to eat	want ( agent = Benjamin , xcomp = eat ( agent = Benjamin ) )
Emma slept	sleep ( agent = Emma )
a cookie was frozen	freeze ( theme = cookie )
the cracker was posted to Olivia	post ( theme = * cracker , recipient = Olivia )
the pickle was dusted	dust ( theme = * pickle )
a girl sneezed	sneeze ( agent = girl )
the rose was helped	help ( theme = * rose )
a donut was mailed to Elijah by the girl	mail ( theme = donut , recipient = Elijah , agent = * girl )
a boy gave the cake to the cat	give ( agent = boy , theme = * cake , recipient = * cat )
a cookie was given to Emma	give ( theme = cookie , recipient = Emma )
a dog lent a donut in the vehicle to Emma	lend ( agent = dog , theme = donut ( nmod . in = * vehicle ) , recipient = Emma )
a jigsaw rolled	roll ( theme = jigsaw )
the producer adored the game in a house	adore ( agent = * producer , theme = * game ( nmod . in = house ) )
the strawberry was brought to the moose by the boy	bring ( theme = * strawberry , recipient = * moose , agent = * boy )
the donut was promised to a turkey by Ethan	promise ( theme = * donut , recipient = turkey , agent = Ethan )
a donut was given to Emma by Olivia	give ( theme = donut , recipient = Emma , agent = Olivia )
Emma intended to run	intend ( agent = Emma , xcomp = run ( agent = Emma ) )
a doctor ate a cake beside a table	eat ( agent = doctor , theme = cake ( nmod . beside = table ) )
a box was grown by the child	grow ( theme = box , agent = * child )
the mouse doubled a cookie	double ( agent = * mouse , theme = cookie )
Lucas scoffed	scoff ( agent = Lucas )
the girl expected to walk	expect ( agent = * girl , xcomp = walk ( agent = * girl ) )
the girl enlarged	enlarge ( theme = * girl )
Liam was given the cake on the stage	give ( recipient = Liam , theme = * cake ( nmod . on = * stage ) )
the biscuit was studied	study ( theme = * biscuit )
the cake was promised to Emma	promise ( theme = * cake , recipient = Emma )
the cat ate a cake	eat ( agent = * cat , theme = cake )
Emma cooked the raisin	cook ( agent = Emma , theme = * raisin )
the cookie was liked	like ( theme = * cookie )
a strawberry was eaten by Victoria	eat ( theme = strawberry , agent = Victoria )
Emma floated	float ( theme = Emma )
a donut was rolled by Emma	roll ( theme = donut , agent = Emma )
the cat gave the block on the towel to a frog	give ( agent = * cat , theme = * block ( nmod . on = * towel ) , recipient = frog )
Noah shortened a cake beside the road	shorten ( agent = Noah , theme = cake ( nmod . beside = * road ) )
Emma supported that the frog brought a basket to the girl	support ( agent = Emma , ccomp = bring ( agent = * frog , theme = basket , recipient = * girl ) )
Jacob was sold a cake beside the table by Emma	sell ( recipient = Jacob , theme = cake ( nmod . beside = * table ) , agent = Emma )
a girl rolled the balloon on the table	roll ( agent = girl , theme = * balloon ( nmod . on = * table ) )
the donut was nursed	nurse ( theme = * donut )
the raisin was adored by a boy	adore ( theme = * raisin , agent = boy )
Jayden ate Emma	eat ( agent = Jayden , theme = Emma )
a cake was given to Emma by the girl	give ( theme = cake , recipient = Emma , agent = * girl )
the banana was shortened	shorten ( theme = * banana )
Zoe said that Elijah served Olivia a cake on a stage	say ( agent = Zoe , ccomp = serve ( agent = Elijah , recipient = Olivia , theme = cake ( nmod . on = stage ) ) )
a sandwich was served to a bear	serve ( theme = sandwich , recipient = bear )
a raisin was disintegrated	disintegrate ( theme = raisin )
the cake was painted	paint ( theme = * cake )
the donut was appreciated	appreciate ( theme = * donut )
Liam liked that a donut was burned by Dylan	like ( agent = Liam , ccomp = burn ( theme = donut , agent = Dylan ) )
a fruit was frozen	freeze ( theme = fruit )
Emma drew	draw ( agent = Emma )
the boy helped the book on the bench	help ( agent = * boy , theme = * book ( nmod . on = * bench ) )
Emma was promised the bat	promise ( recipient = Emma , theme = * bat )
Isabella was passed the box in the house by a cat	pass ( recipient = Isabella , theme = * box ( nmod . in = * house ) , agent = cat )
the bowl was eaten by Olivia	eat ( theme = * bowl , agent = Olivia )
a girl liked the dog	like ( agent = girl , theme = * dog )
Olivia laughed	laugh ( agent = Olivia )
Liam tried to walk	try ( agent = Liam , xcomp = walk ( agent = Liam ) )
Emma packed	pack ( agent = Emma )
a melon was cleaned by the goose	clean ( theme = melon , agent = * goose )
a girl ate Emma	eat ( agent = girl , theme = Emma )
a hen rolled	roll ( theme = hen )
a cat sketched	sketch ( agent = cat )
Ava was served a cake beside a stage	serve ( recipient = Ava , theme = cake ( nmod . beside = stage ) )
the sandwich was loaned to the cat by a boy	loan ( theme = * sandwich , recipient = * cat , agent = boy )
the cake was touched by Abigail	touch ( theme = * cake , agent = Abigail )
the duck appreciated that a frog slept	appreciate ( agent = * duck , ccomp = sleep ( agent = frog ) )
the pillow was frozen	freeze ( theme = * pillow )
a girl disintegrated	disintegrate ( theme = girl )
Emma lent the box to a dog	lend ( agent = Emma , theme = * box , recipient = dog )
a donut was observed	observe ( theme = donut )
the boy slept	sleep ( agent = * boy )
Sofia declared that the glue was rolled by a child	declare ( agent = Sofia , ccomp = roll ( theme = * glue , agent = child ) )
Harper sent a cake to James	send ( agent = Harper , theme = cake , recipient = James )
the cake was found	find ( theme = * cake )
a book was given to Noah by Isabella	give ( theme = book , recipient = Noah , agent = Isabella )
Brooklyn laughed	laugh ( agent = Brooklyn )
a present was crumpled	crumple ( theme = present )
Emma lent the bowl in a can to the boy	lend ( agent = Emma , theme = * bowl ( nmod . in = can ) , recipient = * boy )
a boy painted	paint ( agent = boy )
Emma rolled Noah	roll ( agent = Emma , theme = Noah )
William floated the leaf in a barrel	float ( agent = William , theme = * leaf ( nmod . in = barrel ) )
a cat rolled	roll ( theme = cat )
the drink was lent to the cat	lend ( theme = * drink , recipient = * cat )
a donut was changed by Emma	change ( theme = donut , agent = Emma )
a bat was liked	like ( theme = bat )
a plate was split	split ( theme = plate )
a girl was sold the cake	sell ( recipient = girl , theme = * cake )
a brush was touched by a lion	touch ( theme = brush , agent = lion )
the cake was adored	adore ( theme = * cake )
the farmer smiled	smile ( agent = * farmer )
a girl was lent the cookie in a car by Emma	lend ( recipient = girl , theme = * cookie ( nmod . in = car ) , agent = Emma )
the girl was sold the drink in the car	sell ( recipient = * girl , theme = * drink ( nmod . in = * car ) )
Emma was given a banana	give ( recipient = Emma , theme = banana )
the box was given to Isabella by the frog	give ( theme = * box , recipient = Isabella , agent = * frog )
a cake was respected	respect ( theme = cake )
a rose was eaten by Emma	eat ( theme = rose , agent = Emma )
Emma fed a lamb the raisin beside the poster	feed ( agent = Emma , recipient = lamb , theme = * raisin ( nmod . beside = * poster ) )
a patient was given a box by the boy	give ( recipient = patient , theme = box , agent = * boy )
a cake broke	break ( theme = cake )
Oliver respected that the cookie rolled	respect ( agent = Oliver , ccomp = roll ( theme = * cookie ) )
the cake was seen	see ( theme = * cake )
a cake was offered to a tiger	offer ( theme = cake , recipient = tiger )
Emma admired that a cookie was tolerated by the hen	admire ( agent = Emma , ccomp = tolerate ( theme = cookie , agent = * hen ) )
Olivia shortened Noah	shorten ( agent = Olivia , theme = Noah )
the cookie was cleaned by the girl	clean ( theme = * cookie , agent = * girl )
a girl found the cat	find ( agent = girl , theme = * cat )
the boy liked a pumpkin beside a table	like ( agent = * boy , theme = pumpkin ( nmod . beside = table ) )
the cat passed the glue beside a table to a girl	pass ( agent = * cat , theme = * glue ( nmod . beside = table ) , recipient = girl )
a shirt was nursed	nurse ( theme = shirt )
a can was drawn	draw ( theme = can )
Isabella tolerated that a cat was given a block	tolerate ( agent = Isabella , ccomp = give ( recipient = cat , theme = block ) )
the bell was given to Olivia	give ( theme = * bell , recipient = Olivia )
Liam liked that a cake was cooked by Benjamin	like ( agent = Liam , ccomp = cook ( theme = cake , agent = Benjamin ) )
the monkey loaned the balloon to Emma	loan ( agent = * monkey , theme = * balloon , recipient = Emma )
the donut was floated	float ( theme = * donut )
a pickle was promised to Charlotte	promise ( theme = pickle , recipient = Charlotte )
Michael offered the girl a cookie on a desk	offer ( agent = Michael , recipient = * girl , theme = cookie ( nmod . on = desk ) )
a girl was offered a book on a box	offer ( recipient = girl , theme = book ( nmod . on = box ) )
the gumball was eaten	eat ( theme = * gumball )
Isabella was rented the cake in a wagon by a lion	rent ( recipient = Isabella , theme = * cake ( nmod . in = wagon ) , agent = lion )
Eleanor froze	freeze ( theme = Eleanor )
the cake was liked by a baby	like ( theme = * cake , agent = baby )
a donut was helped	help ( theme = donut )
a girl ate	eat ( agent = girl )
Michael liked that the boy drew the game beside a chair	like ( agent = Michael , ccomp = draw ( agent = * boy , theme = * game ( nmod . beside = chair ) ) )
Emma froze the teacher in the house	freeze ( agent = Emma , theme = * teacher ( nmod . in = * house ) )
a banana was floated by Logan	float ( theme = banana , agent = Logan )
a child ate a cake beside the road	eat ( agent = child , theme = cake ( nmod . beside = * road ) )
Emma wanted to run	want ( agent = Emma , xcomp = run ( agent = Emma ) )
the girl stabbed Olivia	stab ( agent = * girl , theme = Olivia )
the girl gave Noah a cake	give ( agent = * girl , recipient = Noah , theme = cake )
a bean was reddened	redden ( theme = bean )
a girl believed that a cake was respected by Noah	believe ( agent = girl , ccomp = respect ( theme = cake , agent = Noah ) )
Emma liked that the sheep adored Amelia	like ( agent = Emma , ccomp = adore ( agent = * sheep , theme = Amelia ) )
a scarf was eaten	eat ( theme = scarf )
the girl gave the bird the cake	give ( agent = * girl , recipient = * bird , theme = * cake )
a dog awarded the sandwich to Benjamin	award ( agent = dog , theme = * sandwich , recipient = Benjamin )
Abigail rolled the girl on a chair	roll ( agent = Abigail , theme = * girl ( nmod . on = chair ) )
a girl was wired a book	wire ( recipient = girl , theme = book )
Emma wanted to sneeze	want ( agent = Emma , xcomp = sneeze ( agent = Emma ) )
Emma proved that Benjamin rolled	prove ( agent = Emma , ccomp = roll ( theme = Benjamin ) )
a cake was painted by the girl	paint ( theme = cake , agent = * girl )
a box was liked by Emma	like ( theme = box , agent = Emma )
Noah appreciated that Michael respected a girl beside the giant	appreciate ( agent = Noah , ccomp = respect ( agent = Michael , theme = girl ( nmod . beside = * giant ) ) )
the donut was rolled	roll ( theme = * donut )
the farmer sold the cake in the crib to Emma	sell ( agent = * farmer , theme = * cake ( nmod . in = * crib ) , recipient = Emma )
the box was adored by Emma	adore ( theme = * box , agent = Emma )
a cake was given to Liam by Amelia	give ( theme = cake , recipient = Liam , agent = Amelia )
Benjamin rolled	roll ( theme = Benjamin )
the hat was collapsed	collapse ( theme = * hat )
the farmer ate a dog on the bed	eat ( agent = * farmer , theme = dog ( nmod . on = * bed ) )
the boy admired that a donut was called	admire ( agent = * boy , ccomp = call ( theme = donut ) )
Olivia ate a chalk	eat ( agent = Olivia , theme = chalk )
a sandwich was given to Elizabeth by Noah	give ( theme = sandwich , recipient = Elizabeth , agent = Noah )
Emma lent Oliver a bat	lend ( agent = Emma , recipient = Oliver , theme = bat )
a girl poked a ball	poke ( agent = girl , theme = ball )
the donut was helped by a girl	help ( theme = * donut , agent = girl )
the cookie was eaten by the child	eat ( theme = * cookie , agent = * child )
a butterfly sold a dog a rose in the cabinet	sell ( agent = butterfly , recipient = dog , theme = rose ( nmod . in = * cabinet ) )
the cake was tolerated	tolerate ( theme = * cake )
the donut was frozen	freeze ( theme = * donut )
a cat ate a cake beside the tree	eat ( agent = cat , theme = cake ( nmod . beside = * tree ) )
the pretzel was doubled	double ( theme = * pretzel )
the rose changed	change ( theme = * rose )
Emma broke a toothbrush on a computer on the boat	break ( agent = Emma , theme = toothbrush ( nmod . on = computer ( nmod . on = * boat ) ) )
the girl wanted to walk	want ( agent = * girl , xcomp = walk ( agent = * girl ) )
a rose was liked	like ( theme = rose )
the girl was awarded the radio	award ( recipient = * girl , theme = * radio )
Liam was lent the donut by a girl	lend ( recipient = Liam , theme = * donut , agent = girl )
a horse painted Sophia	paint ( agent = horse , theme = Sophia )
the cup was liked	like ( theme = * cup )
Emma was given the rose	give ( recipient = Emma , theme = * rose )
Olivia slept	sleep ( agent = Olivia )
Harper painted	paint ( agent = Harper )
Liam wanted to smirk	want ( agent = Liam , xcomp = smirk ( agent = Liam ) )
a soap was given to the bunny by Emma	give ( theme = soap , recipient = * bunny , agent = Emma )
a girl hoped that a muffin was given to Jackson	hope ( agent = girl , ccomp = give ( theme = muffin , recipient = Jackson ) )
a crayon was tolerated	tolerate ( theme = crayon )
Oliver broke the melon beside a seat	break ( agent = Oliver , theme = * melon ( nmod . beside = seat ) )
Abigail gave Aiden a donut beside the table	give ( agent = Abigail , recipient = Aiden , theme = donut ( nmod . beside = * table ) )
a boy passed a girl the cake on the surface beside a table	pass ( agent = boy , recipient = girl , theme = * cake ( nmod . on = * surface ( nmod . beside = table ) ) )
the cake was given to a horse by the girl	give ( theme = * cake , recipient = horse , agent = * girl )
a cake was dusted	dust ( theme = cake )
the drink split	split ( theme = * drink )
Olivia noticed that the sandwich was adored	notice ( agent = Olivia , ccomp = adore ( theme = * sandwich ) )
a sheep returned Emma a cake	return ( agent = sheep , recipient = Emma , theme = cake )
Isabella packed	pack ( agent = Isabella )
Noah studied a cookie	study ( agent = Noah , theme = cookie )
the pillow was tolerated	tolerate ( theme = * pillow )
Emma examined Olivia	examine ( agent = Emma , theme = Olivia )
the cookie was heard by a girl	hear ( theme = * cookie , agent = girl )
Aiden packed a cookie	pack ( agent = Aiden , theme = cookie )
a pancake was loved by Liam	love ( theme = pancake , agent = Liam )
James promised a cake on the gravel to Liam	promise ( agent = James , theme = cake ( nmod . on = * gravel ) , recipient = Liam )
a frog slid a boy	slide ( agent = frog , theme = boy )
a girl touched the donut beside the stage	touch ( agent = girl , theme = * donut ( nmod . beside = * stage ) )
the hero tolerated Emma	tolerate ( agent = * hero , theme = Emma )
Emma ate a muffin in the room	eat ( agent = Emma , theme = muffin ( nmod . in = * room ) )
Emma offered Amelia a ball beside a stool	offer ( agent = Emma , recipient = Amelia , theme = ball ( nmod . beside = stool ) )
a donut was lent to the boy by Liam	lend ( theme = donut , recipient = * boy , agent = Liam )
the prince loved a bat beside the table	love ( agent = * prince , theme = bat ( nmod . beside = * table ) )
a book was frozen	freeze ( theme = book )
the lollipop was cleaned	clean ( theme = * lollipop )
Olivia liked that Emma preferred to run	like ( agent = Olivia , ccomp = prefer ( agent = Emma , xcomp = run ( agent = Emma ) ) )
a cake was tolerated by Emma	tolerate ( theme = cake , agent = Emma )
a donkey lent Mila the cookie in the house	lend ( agent = donkey , recipient = Mila , theme = * cookie ( nmod . in = * house ) )
Harper gave Ava the cookie beside a table	give ( agent = Harper , recipient = Ava , theme = * cookie ( nmod . beside = table ) )
Emma was given the balloon by a dog	give ( recipient = Emma , theme = * balloon , agent = dog )
the muffin was frozen	freeze ( theme = * muffin )
a cup was drawn	draw ( theme = cup )
the cake was crumpled by Emma	crumple ( theme = * cake , agent = Emma )
a giraffe handed Emma a fig	hand ( agent = giraffe , recipient = Emma , theme = fig )
Elijah burned	burn ( theme = Elijah )
the boy attempted to walk	attempt ( agent = * boy , xcomp = walk ( agent = * boy ) )
the cake was given to Noah by Emma	give ( theme = * cake , recipient = Noah , agent = Emma )
a girl froze Emma	freeze ( agent = girl , theme = Emma )
a chicken drew a coin	draw ( agent = chicken , theme = coin )
a box was given to a professor	give ( theme = box , recipient = professor )
Eleanor rolled a balloon on the notebook on the tree	roll ( agent = Eleanor , theme = balloon ( nmod . on = * notebook ( nmod . on = * tree ) ) )
a brick was improved	improve ( theme = brick )
a girl sold the cake to a chicken	sell ( agent = girl , theme = * cake , recipient = chicken )
Emily drew	draw ( agent = Emily )
the girl liked to clean	like ( agent = * girl , xcomp = clean ( agent = * girl ) )
a creature nursed	nurse ( agent = creature )
the cookie was inflated by Elizabeth	inflate ( theme = * cookie , agent = Elizabeth )
the lawyer gave Olivia a drink in the coffin	give ( agent = * lawyer , recipient = Olivia , theme = drink ( nmod . in = * coffin ) )
a cake was reddened by the boy	redden ( theme = cake , agent = * boy )
the cake was forwarded to the friend by Emma	forward ( theme = * cake , recipient = * friend , agent = Emma )
the pancake was found	find ( theme = * pancake )
the frog saw the pupil in the house	see ( agent = * frog , theme = * pupil ( nmod . in = * house ) )
the girl gave a box to a landlord	give ( agent = * girl , theme = box , recipient = landlord )
the boy cleaned the pickle beside the book	clean ( agent = * boy , theme = * pickle ( nmod . beside = * book ) )
a block was poked	poke ( theme = block )
Olivia drew	draw ( agent = Olivia )
Mia burned a drink	burn ( agent = Mia , theme = drink )
a cake burned	burn ( theme = cake )
the cake was drawn	draw ( theme = * cake )
a cake was found by Noah	find ( theme = cake , agent = Noah )
Emma fed a boy a chalk on a bike	feed ( agent = Emma , recipient = boy , theme = chalk ( nmod . on = bike ) )
a deer was mailed the donut beside a tree by the girl	mail ( recipient = deer , theme = * donut ( nmod . beside = tree ) , agent = * girl )
Emma enlarged the girl	enlarge ( agent = Emma , theme = * girl )
the boy changed the girl beside a glass beside the bag	change ( agent = * boy , theme = * girl ( nmod . beside = glass ( nmod . beside = * bag ) ) )
a cake was poked	poke ( theme = cake )
Asher hoped that John slept	hope ( agent = Asher , ccomp = sleep ( agent = John ) )
a queen offered Emma the cake	offer ( agent = queen , recipient = Emma , theme = * cake )
the dog tolerated that the jigsaw was served to the girl	tolerate ( agent = * dog , ccomp = serve ( theme = * jigsaw , recipient = * girl ) )
Emma rolled a priest in a garden	roll ( agent = Emma , theme = priest ( nmod . in = garden ) )
Elijah enjoyed to run	enjoy ( agent = Elijah , xcomp = run ( agent = Elijah ) )
the doll was shortened by Luna	shorten ( theme = * doll , agent = Luna )
the cake was sold to Abigail by Liam	sell ( theme = * cake , recipient = Abigail , agent = Liam )
Emma was sold a game on the stage	sell ( recipient = Emma , theme = game ( nmod . on = * stage ) )
Logan discovered a girl	discover ( agent = Logan , theme = girl )
the girl rented a balloon in the trap to a pony	rent ( agent = * girl , theme = balloon ( nmod . in = * trap ) , recipient = pony )
the glue was painted by Emma	paint ( theme = * glue , agent = Emma )
Noah ate	eat ( agent = Noah )
the doll was burned	burn ( theme = * doll )
the cake was mailed to Emma	mail ( theme = * cake , recipient = Emma )
Logan was rented a cake in the room by the cat	rent ( recipient = Logan , theme = cake ( nmod . in = * room ) , agent = * cat )
a girl froze the donut in the jar	freeze ( agent = girl , theme = * donut ( nmod . in = * jar ) )
Emma gave a farmer a donut beside the chair	give ( agent = Emma , recipient = farmer , theme = donut ( nmod . beside = * chair ) )
the manager painted Jacob	paint ( agent = * manager , theme = Jacob )
a block was drawn by a president	draw ( theme = block , agent = president )
Ryan painted a bell in the box	paint ( agent = Ryan , theme = bell ( nmod . in = * box ) )
the cat liked that a tool was snapped	like ( agent = * cat , ccomp = snap ( theme = tool ) )
the yogurt was called	call ( theme = * yogurt )
a crayon was floated	float ( theme = crayon )
a lion wanted to sleep	want ( agent = lion , xcomp = sleep ( agent = lion ) )
Elijah hoped that Emily slept	hope ( agent = Elijah , ccomp = sleep ( agent = Emily ) )
Ava froze a cake beside the table	freeze ( agent = Ava , theme = cake ( nmod . beside = * table ) )
Lucas ate	eat ( agent = Lucas )
a mouse smirked	smirk ( agent = mouse )
a cake was grown	grow ( theme = cake )
the balloon rolled	roll ( theme = * balloon )
Noah gave a buyer the cake	give ( agent = Noah , recipient = buyer , theme = * cake )
Emma collapsed the dog beside a table beside a sphere	collapse ( agent = Emma , theme = * dog ( nmod . beside = table ( nmod . beside = sphere ) ) )
the donut was forwarded to the boy by the manager	forward ( theme = * donut , recipient = * boy , agent = * manager )
a bear fed Noah the cake on a computer	feed ( agent = bear , recipient = Noah , theme = * cake ( nmod . on = computer ) )
the guard sent a girl a cookie	send ( agent = * guard , recipient = girl , theme = cookie )
a cake was rolled by a boy	roll ( theme = cake , agent = boy )
the girl painted a boy on a pillow	paint ( agent = * girl , theme = boy ( nmod . on = pillow ) )
a rose was lent to a butterfly	lend ( theme = rose , recipient = butterfly )
a bird offered Olivia the pizza	offer ( agent = bird , recipient = Olivia , theme = * pizza )
a puppy was loaned the cake by the girl	loan ( recipient = puppy , theme = * cake , agent = * girl )
a pumpkin was improved by the boy	improve ( theme = pumpkin , agent = * boy )
a cake was slipped to Aurora	slip ( theme = cake , recipient = Aurora )
a donut was rolled by Aiden	roll ( theme = donut , agent = Aiden )
a cake was valued by a girl	value ( theme = cake , agent = girl )
Olivia cleaned William	clean ( agent = Olivia , theme = William )
Liam pierced the box	pierce ( agent = Liam , theme = * box )
Liam ate	eat ( agent = Liam )
a donut was given to a girl	give ( theme = donut , recipient = girl )
Oliver fed a sandwich to a butterfly	feed ( agent = Oliver , theme = sandwich , recipient = butterfly )
Emma lent a kitty the cake	lend ( agent = Emma , recipient = kitty , theme = * cake )
Avery appreciated the ball	appreciate ( agent = Avery , theme = * ball )
a donut was given to Noah	give ( theme = donut , recipient = Noah )
the melon was rolled by a girl	roll ( theme = * melon , agent = girl )
Ella wanted to sleep	want ( agent = Ella , xcomp = sleep ( agent = Ella ) )
the cake was called	call ( theme = * cake )
a present was given to Olivia	give ( theme = present , recipient = Olivia )
a box was liked by the duck	like ( theme = box , agent = * duck )
the boy ate	eat ( agent = * boy )
the glue was eaten	eat ( theme = * glue )
a champion tried to walk	try ( agent = champion , xcomp = walk ( agent = champion ) )
Mila gave a drink to a girl	give ( agent = Mila , theme = drink , recipient = girl )
Emma hoped that Brooklyn ate	hope ( agent = Emma , ccomp = eat ( agent = Brooklyn ) )
the boy was fed the melon in the vessel	feed ( recipient = * boy , theme = * melon ( nmod . in = * vessel ) )
the dog smiled	smile ( agent = * dog )
the bucket was eaten	eat ( theme = * bucket )
Owen was mailed a sandwich by Daniel	mail ( recipient = Owen , theme = sandwich , agent = Daniel )
a fly changed a bat	change ( agent = fly , theme = bat )
the soap was tolerated	tolerate ( theme = * soap )
Isabella was served the cake by Emma	serve ( recipient = Isabella , theme = * cake , agent = Emma )
Liam crumpled	crumple ( theme = Liam )
a driver lent a cake to the girl	lend ( agent = driver , theme = cake , recipient = * girl )
the patient hoped that the jigsaw was grown	hope ( agent = * patient , ccomp = grow ( theme = * jigsaw ) )
a girl wanted to sleep	want ( agent = girl , xcomp = sleep ( agent = girl ) )
the hero dreamed that Amelia planned to walk	dream ( agent = * hero , ccomp = plan ( agent = Amelia , xcomp = walk ( agent = Amelia ) ) )
a cat painted	paint ( agent = cat )
Abigail preferred to jog	prefer ( agent = Abigail , xcomp = jog ( agent = Abigail ) )
Liam gave a butterfly the cake	give ( agent = Liam , recipient = butterfly , theme = * cake )
Noah gave the banana to Logan	give ( agent = Noah , theme = * banana , recipient = Logan )
Sophia rented a deer the leaf beside a mirror	rent ( agent = Sophia , recipient = deer , theme = * leaf ( nmod . beside = mirror ) )
Emma saw a raisin	see ( agent = Emma , theme = raisin )
a teacher was offered a box by the cat	offer ( recipient = teacher , theme = box , agent = * cat )
Emma passed the rose on the computer to a girl	pass ( agent = Emma , theme = * rose ( nmod . on = * computer ) , recipient = girl )
the box was lent to the pig	lend ( theme = * box , recipient = * pig )
William wanted to walk	want ( agent = William , xcomp = walk ( agent = William ) )
a cloud was improved by a monster	improve ( theme = cloud , agent = monster )
a giraffe reddened Charlotte	redden ( agent = giraffe , theme = Charlotte )
a donut was found by a horse	find ( theme = donut , agent = horse )
a girl was fed a donut	feed ( recipient = girl , theme = donut )
Liam imagined that the button was eaten by the girl	imagine ( agent = Liam , ccomp = eat ( theme = * button , agent = * girl ) )
a cake was frozen	freeze ( theme = cake )
the princess gave the cat the cake beside the torch	give ( agent = * princess , recipient = * cat , theme = * cake ( nmod . beside = * torch ) )
the cake was floated by Lincoln	float ( theme = * cake , agent = Lincoln )
the donut was held	hold ( theme = * donut )
Emma was promised the cookie in the garden	promise ( recipient = Emma , theme = * cookie ( nmod . in = * garden ) )
a girl jogged	jog ( agent = girl )
a girl liked that the cookie improved	like ( agent = girl , ccomp = improve ( theme = * cookie ) )
a rose was given to the horse by Hannah	give ( theme = rose , recipient = * horse , agent = Hannah )
the fig was adored by Liam	adore ( theme = * fig , agent = Liam )
a girl burned the cake	burn ( agent = girl , theme = * cake )
Emma noticed that the boy packed the donut in the cup	notice ( agent = Emma , ccomp = pack ( agent = * boy , theme = * donut ( nmod . in = * cup ) ) )
a block was sold to a duck	sell ( theme = block , recipient = duck )
the cake was disintegrated by Audrey	disintegrate ( theme = * cake , agent = Audrey )
a cookie was dusted	dust ( theme = cookie )
a donut broke	break ( theme = donut )
Isabella thought that the melon was painted by Jack	think ( agent = Isabella , ccomp = paint ( theme = * melon , agent = Jack ) )
the president ate the penny	eat ( agent = * president , theme = * penny )
the cake was given to Liam	give ( theme = * cake , recipient = Liam )
Olivia was given the flower by the boy	give ( recipient = Olivia , theme = * flower , agent = * boy )
Emma lent the cake on the table to a giraffe	lend ( agent = Emma , theme = * cake ( nmod . on = * table ) , recipient = giraffe )
the cake was eaten by Sophia	eat ( theme = * cake , agent = Sophia )
Emma rolled a pillow	roll ( agent = Emma , theme = pillow )
the cake was lent to Jacob by Ethan	lend ( theme = * cake , recipient = Jacob , agent = Ethan )
Emma inflated	inflate ( theme = Emma )
Emma gasped	gasp ( agent = Emma )
Elijah was given the mirror on a bed by Emma	give ( recipient = Elijah , theme = * mirror ( nmod . on = bed ) , agent = Emma )
a cake was crumpled by the driver	crumple ( theme = cake , agent = * driver )
a donut was studied by the girl	study ( theme = donut , agent = * girl )
Noah floated the strawberry in a house	float ( agent = Noah , theme = * strawberry ( nmod . in = house ) )
Harper was served the raisin by a girl	serve ( recipient = Harper , theme = * raisin , agent = girl )
Olivia reddened a cake on a seat	redden ( agent = Olivia , theme = cake ( nmod . on = seat ) )
Ava wanted to nap	want ( agent = Ava , xcomp = nap ( agent = Ava ) )
a banana was lent to a monkey	lend ( theme = banana , recipient = monkey )
the brain was helped by the girl	help ( theme = * brain , agent = * girl )
Leo handed a donut in the house to Charlotte	hand ( agent = Leo , theme = donut ( nmod . in = * house ) , recipient = Charlotte )
Olivia preferred to eat	prefer ( agent = Olivia , xcomp = eat ( agent = Olivia ) )
the hamburger was dusted	dust ( theme = * hamburger )
the girl was sold the donut beside the stage	sell ( recipient = * girl , theme = * donut ( nmod . beside = * stage ) )
Nora needed to walk	need ( agent = Nora , xcomp = walk ( agent = Nora ) )
the cookie was given to Emma	give ( theme = * cookie , recipient = Emma )
the cookie was studied by the girl	study ( theme = * cookie , agent = * girl )
the boy gave Emma the melon in the glass	give ( agent = * boy , recipient = Emma , theme = * melon ( nmod . in = * glass ) )
Grayson was fed a cake	feed ( recipient = Grayson , theme = cake )
a fish crumpled the box	crumple ( agent = fish , theme = * box )
the cake was given to a boy	give ( theme = * cake , recipient = boy )
a rose was tossed by Olivia	toss ( theme = rose , agent = Olivia )
Emma intended to sleep	intend ( agent = Emma , xcomp = sleep ( agent = Emma ) )
a balloon was cleaned	clean ( theme = balloon )
the cake was worshipped	worship ( theme = * cake )
the box was helped by Emma	help ( theme = * box , agent = Emma )
the cookie was adored	adore ( theme = * cookie )
the cake rolled	roll ( theme = * cake )
the cake was given to a frog by the president	give ( theme = * cake , recipient = frog , agent = * president )
a cookie was held	hold ( theme = cookie )
a shoe was reddened by a dog	redden ( theme = shoe , agent = dog )
the cake was returned to James	return ( theme = * cake , recipient = James )
the rose was burned by Emma	burn ( theme = * rose , agent = Emma )
a girl screamed	scream ( agent = girl )
the cake was eaten by Emma	eat ( theme = * cake , agent = Emma )
the girl was given a ball on the hanger on a table by Noah	give ( recipient = * girl , theme = ball ( nmod . on = * hanger ( nmod . on = table ) ) , agent = Noah )
the raisin shortened	shorten ( theme = * raisin )
a rose was sent to a deer by Nathan	send ( theme = rose , recipient = deer , agent = Nathan )
a can was given to a teacher	give ( theme = can , recipient = teacher )
a girl liked a monkey	like ( agent = girl , theme = monkey )
Emma examined a cake beside the wolf	examine ( agent = Emma , theme = cake ( nmod . beside = * wolf ) )
a cake was promised to Emma	promise ( theme = cake , recipient = Emma )
a banana was liked by Sophia	like ( theme = banana , agent = Sophia )
a bird slept	sleep ( agent = bird )
Noah sent a girl the cake on a speaker beside a bed	send ( agent = Noah , recipient = girl , theme = * cake ( nmod . on = speaker ( nmod . beside = bed ) ) )
the horse was lent the strawberry	lend ( recipient = * horse , theme = * strawberry )
the girl lent a father the cake beside the table on the bed	lend ( agent = * girl , recipient = father , theme = * cake ( nmod . beside = * table ( nmod . on = * bed ) ) )
the bell was cleaned by Julian	clean ( theme = * bell , agent = Julian )
Liam helped the donut in the room	help ( agent = Liam , theme = * donut ( nmod . in = * room ) )
a boy ate a radio	eat ( agent = boy , theme = radio )
a cat ate the donut on a bed	eat ( agent = cat , theme = * donut ( nmod . on = bed ) )
the prince was served the donut beside the stage	serve ( recipient = * prince , theme = * donut ( nmod . beside = * stage ) )
a girl rolled a cake in the house	roll ( agent = girl , theme = cake ( nmod . in = * house ) )
a teacher ate a cake	eat ( agent = teacher , theme = cake )
the jacket was doubled	double ( theme = * jacket )
James ate	eat ( agent = James )
a donkey was given the cake beside a table	give ( recipient = donkey , theme = * cake ( nmod . beside = table ) )
the girl preferred to walk	prefer ( agent = * girl , xcomp = walk ( agent = * girl ) )
Olivia lent Ava a cake beside the chair	lend ( agent = Olivia , recipient = Ava , theme = cake ( nmod . beside = * chair ) )
a toy was rolled by Olivia	roll ( theme = toy , agent = Olivia )
Sofia ate	eat ( agent = Sofia )
the rose was liked by a lawyer	like ( theme = * rose , agent = lawyer )
a donut was rolled	roll ( theme = donut )
the cake was appreciated	appreciate ( theme = * cake )
the baby crumpled a pony	crumple ( agent = * baby , theme = pony )
a cake was frozen by a lion	freeze ( theme = cake , agent = lion )
a banana was offered to Liam by Emma	offer ( theme = banana , recipient = Liam , agent = Emma )
the wine was doubled by Sofia	double ( theme = * wine , agent = Sofia )
a box was painted	paint ( theme = box )
the girl stabbed a cat	stab ( agent = * girl , theme = cat )
Oliver smiled	smile ( agent = Oliver )
Alexander worshipped Liam	worship ( agent = Alexander , theme = Liam )
Liam wanted to cook	want ( agent = Liam , xcomp = cook ( agent = Liam ) )
Emma liked that a cake was loved	like ( agent = Emma , ccomp = love ( theme = cake ) )
William painted	paint ( agent = William )
a raisin was frozen by the girl	freeze ( theme = raisin , agent = * girl )
a girl packed	pack ( agent = girl )
Scarlett painted Jacob	paint ( agent = Scarlett , theme = Jacob )
a hammer was floated	float ( theme = hammer )
the donut was passed to Liam	pass ( theme = * donut , recipient = Liam )
Liam napped	nap ( agent = Liam )
the bunny adored a girl on the stage	adore ( agent = * bunny , theme = girl ( nmod . on = * stage ) )
the wolf danced	dance ( agent = * wolf )
Emma handed the cake beside the stage to a girl	hand ( agent = Emma , theme = * cake ( nmod . beside = * stage ) , recipient = girl )
Emma wanted to nap	want ( agent = Emma , xcomp = nap ( agent = Emma ) )
Emma painted the melon beside the worm	paint ( agent = Emma , theme = * melon ( nmod . beside = * worm ) )
Emma was lent a cake in a room by the baby	lend ( recipient = Emma , theme = cake ( nmod . in = room ) , agent = * baby )
Aurora lent a donut to the chicken	lend ( agent = Aurora , theme = donut , recipient = * chicken )
the flag was poked	poke ( theme = * flag )
the donut was eaten by a professor	eat ( theme = * donut , agent = professor )
James helped the child in a vehicle	help ( agent = James , theme = * child ( nmod . in = vehicle ) )
the girl wished to run	wish ( agent = * girl , xcomp = run ( agent = * girl ) )
Emma burned	burn ( theme = Emma )
the girl wanted to eat	want ( agent = * girl , xcomp = eat ( agent = * girl ) )
a friend cooked a mirror in a room	cook ( agent = friend , theme = mirror ( nmod . in = room ) )
Emma liked that the cookie froze	like ( agent = Emma , ccomp = freeze ( theme = * cookie ) )
the donut was eaten	eat ( theme = * donut )
Emma preferred to walk	prefer ( agent = Emma , xcomp = walk ( agent = Emma ) )
Daniel painted	paint ( agent = Daniel )
the watch was brought to William by Noah	bring ( theme = * watch , recipient = William , agent = Noah )
the game disintegrated	disintegrate ( theme = * game )
Liam was lent a pickle in a cup	lend ( recipient = Liam , theme = pickle ( nmod . in = cup ) )
James was brought a cake by a sailor	bring ( recipient = James , theme = cake , agent = sailor )
the king sold a cake beside the table in a house to the cat	sell ( agent = * king , theme = cake ( nmod . beside = * table ( nmod . in = house ) ) , recipient = * cat )
Ellie liked a cake	like ( agent = Ellie , theme = cake )
the bear rolled	roll ( theme = * bear )
the cake was sketched by the baby	sketch ( theme = * cake , agent = * baby )
the donut was grown	grow ( theme = * donut )
a box was juggled	juggle ( theme = box )
the cake was rolled by Sebastian	roll ( theme = * cake , agent = Sebastian )
a puppy preferred to walk	prefer ( agent = puppy , xcomp = walk ( agent = puppy ) )
a melon was adored by Isabella	adore ( theme = melon , agent = Isabella )
the toothbrush was rolled	roll ( theme = * toothbrush )
Emma poked Oliver	poke ( agent = Emma , theme = Oliver )
Emma reddened a baby	redden ( agent = Emma , theme = baby )
the ring was fed to Nathan	feed ( theme = * ring , recipient = Nathan )
Noah was sold the donut in a coffin	sell ( recipient = Noah , theme = * donut ( nmod . in = coffin ) )
a banana was given to the boy	give ( theme = banana , recipient = * boy )
the boy was awarded a cake on a table	award ( recipient = * boy , theme = cake ( nmod . on = table ) )
the consumer tried to sneeze	try ( agent = * consumer , xcomp = sneeze ( agent = * consumer ) )
the mouse liked James	like ( agent = * mouse , theme = James )
a boy tolerated that a crystal was lent to a bird by a girl	tolerate ( agent = boy , ccomp = lend ( theme = crystal , recipient = bird , agent = girl ) )
a monster was given the box beside the table by a girl	give ( recipient = monster , theme = * box ( nmod . beside = * table ) , agent = girl )
Emma sold the bunny a fig	sell ( agent = Emma , recipient = * bunny , theme = fig )
the boy liked that Michael loved a cake beside a table	like ( agent = * boy , ccomp = love ( agent = Michael , theme = cake ( nmod . beside = table ) ) )
the girl liked to read	like ( agent = * girl , xcomp = read ( agent = * girl ) )
a cake was touched	touch ( theme = cake )
the cake was respected	respect ( theme = * cake )
a girl was offered a cake by Emma	offer ( recipient = girl , theme = cake , agent = Emma )
Emma proved that the boy ate the cake	prove ( agent = Emma , ccomp = eat ( agent = * boy , theme = * cake ) )
Elijah rolled	roll ( theme = Elijah )
James thought that Amelia split	think ( agent = James , ccomp = split ( theme = Amelia ) )
a cake was juggled	juggle ( theme = cake )
the lion was given the cake on the pillow	give ( recipient = * lion , theme = * cake ( nmod . on = * pillow ) )
the boy confessed that the cake was cleaned	confess ( agent = * boy , ccomp = clean ( theme = * cake ) )
the crayon was pierced by Nora	pierce ( theme = * crayon , agent = Nora )
Wyatt gave a girl a box beside a lamp	give ( agent = Wyatt , recipient = girl , theme = box ( nmod . beside = lamp ) )
the cat burned the cake in a tin	burn ( agent = * cat , theme = * cake ( nmod . in = tin ) )
a child threw a strawberry beside the stage	throw ( agent = child , theme = strawberry ( nmod . beside = * stage ) )
Emma liked a cookie	like ( agent = Emma , theme = cookie )
a toothbrush was rolled by the cat	roll ( theme = toothbrush , agent = * cat )
the basket was studied	study ( theme = * basket )
the tiger disintegrated Noah	disintegrate ( agent = * tiger , theme = Noah )
a gumball was rolled by Emma	roll ( theme = gumball , agent = Emma )
a girl observed a dog in the house	observe ( agent = girl , theme = dog ( nmod . in = * house ) )
Oliver gave the cake to Liam	give ( agent = Oliver , theme = * cake , recipient = Liam )
Noah cried	cry ( agent = Noah )
a sandwich rolled	roll ( theme = sandwich )
the chemical was drawn	draw ( theme = * chemical )
the bear fed Liam a cake on the canvas	feed ( agent = * bear , recipient = Liam , theme = cake ( nmod . on = * canvas ) )
a boy liked the cake beside a speaker	like ( agent = boy , theme = * cake ( nmod . beside = speaker ) )
the strawberry was rolled	roll ( theme = * strawberry )
Leah gave the donut beside a table to Olivia	give ( agent = Leah , theme = * donut ( nmod . beside = table ) , recipient = Olivia )
the cookie was liked by Liam	like ( theme = * cookie , agent = Liam )
the girl slept	sleep ( agent = * girl )
a cookie was rolled	roll ( theme = cookie )
a girl imagined that Emma was sold a cake	imagine ( agent = girl , ccomp = sell ( recipient = Emma , theme = cake ) )
Emma liked that a pillow was poked	like ( agent = Emma , ccomp = poke ( theme = pillow ) )
the girl painted	paint ( agent = * girl )
Olivia was given the pencil	give ( recipient = Olivia , theme = * pencil )
a cup was eaten	eat ( theme = cup )
a bowl was touched by Emma	touch ( theme = bowl , agent = Emma )
a judge drew	draw ( agent = judge )
a girl gave the cake on a seat to Charlotte	give ( agent = girl , theme = * cake ( nmod . on = seat ) , recipient = Charlotte )
a lollipop was lent to a teacher by Emma	lend ( theme = lollipop , recipient = teacher , agent = Emma )
the girl returned a donut on the truck to a monkey	return ( agent = * girl , theme = donut ( nmod . on = * truck ) , recipient = monkey )
Aubrey poked the donut	poke ( agent = Aubrey , theme = * donut )
the box was liked	like ( theme = * box )
a spoon was helped	help ( theme = spoon )
David reddened a cake beside a bike	redden ( agent = David , theme = cake ( nmod . beside = bike ) )
the priest cooked the rose on a table in the room	cook ( agent = * priest , theme = * rose ( nmod . on = table ( nmod . in = * room ) ) )
a donut was liked by a mouse	like ( theme = donut , agent = mouse )
the banana was rolled	roll ( theme = * banana )
the raisin was poked	poke ( theme = * raisin )
a cake was given to William	give ( theme = cake , recipient = William )
the cookie was rented to a frog by Noah	rent ( theme = * cookie , recipient = frog , agent = Noah )
Evelyn was sold the donut beside the table by a girl	sell ( recipient = Evelyn , theme = * donut ( nmod . beside = * table ) , agent = girl )
a girl supported that Liam dreamed that a strawberry was decomposed	support ( agent = girl , ccomp = dream ( agent = Liam , ccomp = decompose ( theme = strawberry ) ) )
a cat sketched Noah	sketch ( agent = cat , theme = Noah )
Liam awarded the child a cake	award ( agent = Liam , recipient = * child , theme = cake )
Ava admired a boy on a log	admire ( agent = Ava , theme = boy ( nmod . on = log ) )
a game was helped	help ( theme = game )
the donut froze	freeze ( theme = * donut )
Olivia wanted to nap	want ( agent = Olivia , xcomp = nap ( agent = Olivia ) )
Emma disintegrated a boy	disintegrate ( agent = Emma , theme = boy )
a donut was pierced	pierce ( theme = donut )
Emma gave a boy the rose in the vessel	give ( agent = Emma , recipient = boy , theme = * rose ( nmod . in = * vessel ) )
a cake was poked by a monkey	poke ( theme = cake , agent = monkey )
Sebastian painted a cookie in the vehicle on a table	paint ( agent = Sebastian , theme = cookie ( nmod . in = * vehicle ( nmod . on = table ) ) )
Liam intended to run	intend ( agent = Liam , xcomp = run ( agent = Liam ) )
Zoey liked the cup in the car	like ( agent = Zoey , theme = * cup ( nmod . in = * car ) )
Alexander poked the boy on the tree	poke ( agent = Alexander , theme = * boy ( nmod . on = * tree ) )
a cake was sold to Liam by a coach	sell ( theme = cake , recipient = Liam , agent = coach )
Mia liked that a sandwich was given to Liam by Lucas	like ( agent = Mia , ccomp = give ( theme = sandwich , recipient = Liam , agent = Lucas ) )
a monster liked Charlotte	like ( agent = monster , theme = Charlotte )
a patient gave the donut beside a table to the bear	give ( agent = patient , theme = * donut ( nmod . beside = table ) , recipient = * bear )
a cake was helped by Ava	help ( theme = cake , agent = Ava )
a girl hunted a cake	hunt ( agent = girl , theme = cake )
Liam reddened	redden ( theme = Liam )
Noah dreamed that a bat was given to the dog	dream ( agent = Noah , ccomp = give ( theme = bat , recipient = * dog ) )
Liam liked a cake on the surface	like ( agent = Liam , theme = cake ( nmod . on = * surface ) )
a donut was posted to a chief by Emma	post ( theme = donut , recipient = chief , agent = Emma )
a cake was liked	like ( theme = cake )
a box was mailed to a girl	mail ( theme = box , recipient = girl )
the girl rented the donut to the child	rent ( agent = * girl , theme = * donut , recipient = * child )
a girl hoped to run	hope ( agent = girl , xcomp = run ( agent = girl ) )
a lamb liked Riley	like ( agent = lamb , theme = Riley )
the flag was given to a girl by Noah	give ( theme = * flag , recipient = girl , agent = Noah )
Emma needed to walk	need ( agent = Emma , xcomp = walk ( agent = Emma ) )
a drink was burned by the queen	burn ( theme = drink , agent = * queen )
a bird was given a bowl	give ( recipient = bird , theme = bowl )
a glue was passed to the lion by Liam	pass ( theme = glue , recipient = * lion , agent = Liam )
a kid liked Emma	like ( agent = kid , theme = Emma )
the bottle was passed to a chicken by the boy	pass ( theme = * bottle , recipient = chicken , agent = * boy )
a cake rolled	roll ( theme = cake )
a cookie was passed to Emma	pass ( theme = cookie , recipient = Emma )
Mason meant that a cookie was found by a girl	mean ( agent = Mason , ccomp = find ( theme = cookie , agent = girl ) )
a dog ate	eat ( agent = dog )
the butterfly was fed the rose beside a table by a bird	feed ( recipient = * butterfly , theme = * rose ( nmod . beside = table ) , agent = bird )
the professor said that the bat was painted	say ( agent = * professor , ccomp = paint ( theme = * bat ) )
a cookie was valued	value ( theme = cookie )
Emma helped a boy	help ( agent = Emma , theme = boy )
a block was served to a cat by a boy	serve ( theme = block , recipient = cat , agent = boy )
Evelyn worshipped Sebastian	worship ( agent = Evelyn , theme = Sebastian )
the girl called Liam	call ( agent = * girl , theme = Liam )
Emma gave the cake on a table to the frog	give ( agent = Emma , theme = * cake ( nmod . on = table ) , recipient = * frog )
a boy noticed	notice ( agent = boy )
a sweetcorn was liked by Ava	like ( theme = sweetcorn , agent = Ava )
the bean was liked	like ( theme = * bean )
Emma dusted Noah	dust ( agent = Emma , theme = Noah )
a rose was frozen	freeze ( theme = rose )
the girl painted Luke	paint ( agent = * girl , theme = Luke )
the cake was broken by Alexander	break ( theme = * cake , agent = Alexander )
a cake was sold to the boy by the lion	sell ( theme = cake , recipient = * boy , agent = * lion )
the box was fed to Emma	feed ( theme = * box , recipient = Emma )
the champion ate	eat ( agent = * champion )
Emma sold the boy a doll beside a table	sell ( agent = Emma , recipient = * boy , theme = doll ( nmod . beside = table ) )
the raisin was liked	like ( theme = * raisin )
the strawberry was cooked by Emma	cook ( theme = * strawberry , agent = Emma )
the cat decomposed a girl on the table	decompose ( agent = * cat , theme = girl ( nmod . on = * table ) )
the turtle liked that the girl wired a crystal to Harper	like ( agent = * turtle , ccomp = wire ( agent = * girl , theme = crystal , recipient = Harper ) )
the cake was given to a girl	give ( theme = * cake , recipient = girl )
the girl sold a toothbrush to Emma	sell ( agent = * girl , theme = toothbrush , recipient = Emma )
a girl doubled	double ( theme = girl )
the boy cleaned Ella	clean ( agent = * boy , theme = Ella )
a shoe was burned	burn ( theme = shoe )
the chicken liked that a cookie froze	like ( agent = * chicken , ccomp = freeze ( theme = cookie ) )
a crayon was rolled by Benjamin	roll ( theme = crayon , agent = Benjamin )
William nursed a cake beside the sculpture	nurse ( agent = William , theme = cake ( nmod . beside = * sculpture ) )
the cookie was sold to the cat by Emma	sell ( theme = * cookie , recipient = * cat , agent = Emma )
the dog walked	walk ( agent = * dog )
the bottle snapped	snap ( theme = * bottle )
the yogurt was passed to a dog	pass ( theme = * yogurt , recipient = dog )
a girl was fed a cake	feed ( recipient = girl , theme = cake )
the cake was painted by a girl	paint ( theme = * cake , agent = girl )
the cat needed to walk	need ( agent = * cat , xcomp = walk ( agent = * cat ) )
the lion ate	eat ( agent = * lion )
a rose was sketched	sketch ( theme = rose )
the frog inflated the crocodile in the room	inflate ( agent = * frog , theme = * crocodile ( nmod . in = * room ) )
the girl drew Sofia	draw ( agent = * girl , theme = Sofia )
the cake was drawn by Emma	draw ( theme = * cake , agent = Emma )
a journalist rented a drink in a truck to Liam	rent ( agent = journalist , theme = drink ( nmod . in = truck ) , recipient = Liam )
Liam floated	float ( theme = Liam )
the melon was rolled by Elizabeth	roll ( theme = * melon , agent = Elizabeth )
a girl reddened Liam	redden ( agent = girl , theme = Liam )
Emma liked a boy	like ( agent = Emma , theme = boy )
the sandwich improved	improve ( theme = * sandwich )
a girl shortened	shorten ( theme = girl )
the pencil was rolled	roll ( theme = * pencil )
the frog gave the girl a rose beside the table	give ( agent = * frog , recipient = * girl , theme = rose ( nmod . beside = * table ) )
a boy wanted to sleep	want ( agent = boy , xcomp = sleep ( agent = boy ) )
the donut inflated	inflate ( theme = * donut )
a cake was floated by Ava	float ( theme = cake , agent = Ava )
the cat painted	paint ( agent = * cat )
the cake was offered to a baby by Emma	offer ( theme = * cake , recipient = baby , agent = Emma )
a teacher sneezed	sneeze ( agent = teacher )
a bottle was offered to Emma by Nathan	offer ( theme = bottle , recipient = Emma , agent = Nathan )
Noah passed the drink in the mug to a boy	pass ( agent = Noah , theme = * drink ( nmod . in = * mug ) , recipient = boy )
Sophia hunted the teacher	hunt ( agent = Sophia , theme = * teacher )
the key was helped by Emma	help ( theme = * key , agent = Emma )
Emma doubled	double ( theme = Emma )
a boy cleaned the cake on a bed	clean ( agent = boy , theme = * cake ( nmod . on = bed ) )
Jacob lent the cake on the box to Ava	lend ( agent = Jacob , theme = * cake ( nmod . on = * box ) , recipient = Ava )
a donut was awarded to Emma by Alexander	award ( theme = donut , recipient = Emma , agent = Alexander )
a prisoner dusted the book	dust ( agent = prisoner , theme = * book )
the cake was handed to Emma	hand ( theme = * cake , recipient = Emma )
a cracker was found by a chicken	find ( theme = cracker , agent = chicken )
a cat crumpled Liam	crumple ( agent = cat , theme = Liam )
Camila attempted to walk	attempt ( agent = Camila , xcomp = walk ( agent = Camila ) )
a boy enlarged	enlarge ( theme = boy )
the donut was broken	break ( theme = * donut )
Emily liked the box	like ( agent = Emily , theme = * box )
a donut was poked	poke ( theme = donut )
a donut was liked	like ( theme = donut )
Liam was given a cake by the girl	give ( recipient = Liam , theme = cake , agent = * girl )
Liam rolled a professor in the cup	roll ( agent = Liam , theme = professor ( nmod . in = * cup ) )
a cup was admired by Elizabeth	admire ( theme = cup , agent = Elizabeth )
Isabella fed the chalk to the girl	feed ( agent = Isabella , theme = * chalk , recipient = * girl )
a teacher sold a cake to the cat	sell ( agent = teacher , theme = cake , recipient = * cat )
Sofia tolerated a melon	tolerate ( agent = Sofia , theme = melon )
Isabella liked that the cake was fed to the hero by a writer	like ( agent = Isabella , ccomp = feed ( theme = * cake , recipient = * hero , agent = writer ) )
Emma believed that Mia mailed a cake to a girl	believe ( agent = Emma , ccomp = mail ( agent = Mia , theme = cake , recipient = girl ) )
a cake was found by Carter	find ( theme = cake , agent = Carter )
Noah painted	paint ( agent = Noah )
Emma laughed	laugh ( agent = Emma )
Emma found a girl in the bookstore in the house	find ( agent = Emma , theme = girl ( nmod . in = * bookstore ( nmod . in = * house ) ) )
Ava was sold the sandwich on a table	sell ( recipient = Ava , theme = * sandwich ( nmod . on = table ) )
the cat was loaned the raisin in a room in the car by Liam	loan ( recipient = * cat , theme = * raisin ( nmod . in = room ( nmod . in = * car ) ) , agent = Liam )
Sofia painted	paint ( agent = Sofia )
a father ate	eat ( agent = father )
a jigsaw was eaten	eat ( theme = jigsaw )
a drink burned	burn ( theme = drink )
Olivia rented a cake beside the bed to a bear	rent ( agent = Olivia , theme = cake ( nmod . beside = * bed ) , recipient = bear )
the writer examined a cookie on the surface	examine ( agent = * writer , theme = cookie ( nmod . on = * surface ) )
the needle was burned	burn ( theme = * needle )
a box was posted to a girl by Emma	post ( theme = box , recipient = girl , agent = Emma )
the hammer was split by the captain	split ( theme = * hammer , agent = * captain )
Emma gave the pencil to a frog	give ( agent = Emma , theme = * pencil , recipient = frog )
Aurora hunted Emma	hunt ( agent = Aurora , theme = Emma )
a cake was split by the politician	split ( theme = cake , agent = * politician )
the drink was admired	admire ( theme = * drink )
John gave a girl the cookie	give ( agent = John , recipient = girl , theme = * cookie )
a girl rolled Olivia	roll ( agent = girl , theme = Olivia )
a cookie disintegrated	disintegrate ( theme = cookie )
the cake was liked	like ( theme = * cake )
the dealer improved a girl beside the bed	improve ( agent = * dealer , theme = girl ( nmod . beside = * bed ) )
the customer liked a cake on a road	like ( agent = * customer , theme = cake ( nmod . on = road ) )
the mandarin was reddened by a girl	redden ( theme = * mandarin , agent = girl )
a raisin was broken	break ( theme = raisin )
the girl painted the donut beside the bed	paint ( agent = * girl , theme = * donut ( nmod . beside = * bed ) )
Emma packed a cake in the house	pack ( agent = Emma , theme = cake ( nmod . in = * house ) )
Emma nursed	nurse ( agent = Emma )
a pupil froze a sandwich beside a vehicle	freeze ( agent = pupil , theme = sandwich ( nmod . beside = vehicle ) )
the rose was helped by Ava	help ( theme = * rose , agent = Ava )
a cup was broken by Scarlett	break ( theme = cup , agent = Scarlett )
the raisin was eaten by Liam	eat ( theme = * raisin , agent = Liam )
the boy liked the cake beside the table	like ( agent = * boy , theme = * cake ( nmod . beside = * table ) )
a prince hoped that Noah gave Emma a biscuit in the coffin	hope ( agent = prince , ccomp = give ( agent = Noah , recipient = Emma , theme = biscuit ( nmod . in = * coffin ) ) )
Emma loved the girl	love ( agent = Emma , theme = * girl )
a drink was liked by Aubrey	like ( theme = drink , agent = Aubrey )
Elijah wanted to walk	want ( agent = Elijah , xcomp = walk ( agent = Elijah ) )
a cow danced	dance ( agent = cow )
a jigsaw was slid	slide ( theme = jigsaw )
a cake was valued by Liam	value ( theme = cake , agent = Liam )
a guest gave Emma the drink beside the tree	give ( agent = guest , recipient = Emma , theme = * drink ( nmod . beside = * tree ) )
Logan was offered the donut beside the tree on a bed	offer ( recipient = Logan , theme = * donut ( nmod . beside = * tree ( nmod . on = bed ) ) )
the girl liked a donut	like ( agent = * girl , theme = donut )
a passenger gave the cake to Evelyn	give ( agent = passenger , theme = * cake , recipient = Evelyn )
a crayon was seen by Olivia	see ( theme = crayon , agent = Olivia )
the dog grew	grow ( theme = * dog )
the cake was loaned to the farmer by the girl	loan ( theme = * cake , recipient = * farmer , agent = * girl )
the butterfly fed the cookie to the boy	feed ( agent = * butterfly , theme = * cookie , recipient = * boy )
Hannah proved that the cat packed	prove ( agent = Hannah , ccomp = pack ( agent = * cat ) )
a donut was dusted	dust ( theme = donut )
a dog liked Liam	like ( agent = dog , theme = Liam )
a brain was rolled	roll ( theme = brain )
the cat gave a kid a cake	give ( agent = * cat , recipient = kid , theme = cake )
the box was passed to a frog by Emma	pass ( theme = * box , recipient = frog , agent = Emma )
a scientist saw	see ( agent = scientist )
the brick was wired to Emma by Charlotte	wire ( theme = * brick , recipient = Emma , agent = Charlotte )
the chicken hoped that a cat ate	hope ( agent = * chicken , ccomp = eat ( agent = cat ) )
Emma sneezed	sneeze ( agent = Emma )
the drink was rolled	roll ( theme = * drink )
Riley slid	slide ( theme = Riley )
a cat gave Emma the donut on the vessel	give ( agent = cat , recipient = Emma , theme = * donut ( nmod . on = * vessel ) )
Liam attempted to nap	attempt ( agent = Liam , xcomp = nap ( agent = Liam ) )
Sophia was offered the cake in a box by Emma	offer ( recipient = Sophia , theme = * cake ( nmod . in = box ) , agent = Emma )
the penny was sold to the mouse by the girl	sell ( theme = * penny , recipient = * mouse , agent = * girl )
a girl liked the donut	like ( agent = girl , theme = * donut )
a dog loved Liam	love ( agent = dog , theme = Liam )
the bat was rolled by the dog	roll ( theme = * bat , agent = * dog )
the cookie was sketched by a chicken	sketch ( theme = * cookie , agent = chicken )
the cake was missed	miss ( theme = * cake )
Emma declared that a block was passed to Olivia	declare ( agent = Emma , ccomp = pass ( theme = block , recipient = Olivia ) )
Emma liked that the drink slid	like ( agent = Emma , ccomp = slide ( theme = * drink ) )
a dog froze	freeze ( theme = dog )
the donut was helped	help ( theme = * donut )
the doll was rolled by the deer	roll ( theme = * doll , agent = * deer )
a driver doubled	double ( theme = driver )
the baby ate	eat ( agent = * baby )
the melon was dusted	dust ( theme = * melon )
a cookie was burned by a girl	burn ( theme = cookie , agent = girl )
the child gave Sophia a cake	give ( agent = * child , recipient = Sophia , theme = cake )
the dog was awarded a chalk on a table by the princess	award ( recipient = * dog , theme = chalk ( nmod . on = table ) , agent = * princess )
a goose smiled	smile ( agent = goose )
Olivia cooked	cook ( agent = Olivia )
the cat collapsed	collapse ( theme = * cat )
Layla liked a cake on the leaflet	like ( agent = Layla , theme = cake ( nmod . on = * leaflet ) )
a ball was given to a dog	give ( theme = ball , recipient = dog )
the baby packed	pack ( agent = * baby )
a cookie was eaten by Joshua	eat ( theme = cookie , agent = Joshua )
Nora slept	sleep ( agent = Nora )
the jigsaw was nursed by Liam	nurse ( theme = * jigsaw , agent = Liam )
Emma grew	grow ( theme = Emma )
a cake was liked by Isabella	like ( theme = cake , agent = Isabella )
the box was given to a professor by Emma	give ( theme = * box , recipient = professor , agent = Emma )
Emma was given the cake by Avery	give ( recipient = Emma , theme = * cake , agent = Avery )
the donut was given to the girl by Emma	give ( theme = * donut , recipient = * girl , agent = Emma )
Noah hoped that Liam was lent a strawberry in the room	hope ( agent = Noah , ccomp = lend ( recipient = Liam , theme = strawberry ( nmod . in = * room ) ) )
the girl rolled the crocodile	roll ( agent = * girl , theme = * crocodile )
a balloon was seen by the girl	see ( theme = balloon , agent = * girl )
the professor handed a strawberry to a girl	hand ( agent = * professor , theme = strawberry , recipient = girl )
the bee needed to sleep	need ( agent = * bee , xcomp = sleep ( agent = * bee ) )
a duck ate	eat ( agent = duck )
a ball was rolled by Olivia	roll ( theme = ball , agent = Olivia )
a jigsaw was cleaned	clean ( theme = jigsaw )
a cat called a boy	call ( agent = cat , theme = boy )
the cake was liked by Julian	like ( theme = * cake , agent = Julian )
the manager stuttered	stutter ( agent = * manager )
the lion painted the watch in the trap on a chair	paint ( agent = * lion , theme = * watch ( nmod . in = * trap ( nmod . on = chair ) ) )
a fig was floated	float ( theme = fig )
the child studied	study ( agent = * child )
the pony was sold a cake in a room	sell ( recipient = * pony , theme = cake ( nmod . in = room ) )
the cake was eaten by the mouse	eat ( theme = * cake , agent = * mouse )
Hannah liked that the book was held	like ( agent = Hannah , ccomp = hold ( theme = * book ) )
a donut was held	hold ( theme = donut )
the passenger gave a girl a cake	give ( agent = * passenger , recipient = girl , theme = cake )
the pupil slept	sleep ( agent = * pupil )
the raisin was examined	examine ( theme = * raisin )
a cake was given to the boy	give ( theme = cake , recipient = * boy )
the president painted	paint ( agent = * president )
a donut was respected	respect ( theme = donut )
a fly was mailed the drink	mail ( recipient = fly , theme = * drink )
Noah tried to dust	try ( agent = Noah , xcomp = dust ( agent = Noah ) )
a chalk was eaten by Emma	eat ( theme = chalk , agent = Emma )
a bee gave Emma the donut in a tin	give ( agent = bee , recipient = Emma , theme = * donut ( nmod . in = tin ) )
the donut was frozen by Henry	freeze ( theme = * donut , agent = Henry )
the child was mailed a donut in a house	mail ( recipient = * child , theme = donut ( nmod . in = house ) )
a beer was discovered	discover ( theme = beer )
the cake was burned	burn ( theme = * cake )
Lucas rolled	roll ( theme = Lucas )
Emma noticed that the sandwich was changed	notice ( agent = Emma , ccomp = change ( theme = * sandwich ) )
a champion rolled	roll ( theme = champion )
a girl helped Olivia	help ( agent = girl , theme = Olivia )
the cake was frozen	freeze ( theme = * cake )
Charlotte froze Emma	freeze ( agent = Charlotte , theme = Emma )
a customer was passed the cake beside a TV	pass ( recipient = customer , theme = * cake ( nmod . beside = TV ) )
a cup was hunted	hunt ( theme = cup )
a cat painted Ryan	paint ( agent = cat , theme = Ryan )
a frog wanted to walk	want ( agent = frog , xcomp = walk ( agent = frog ) )
a girl changed	change ( theme = girl )
the girl planned to walk	plan ( agent = * girl , xcomp = walk ( agent = * girl ) )
a girl split	split ( theme = girl )
the pen rolled	roll ( theme = * pen )
Emma examined the girl on the table	examine ( agent = Emma , theme = * girl ( nmod . on = * table ) )
Leo gave the penguin the donut on the deck	give ( agent = Leo , recipient = * penguin , theme = * donut ( nmod . on = * deck ) )
the child hunted Emma	hunt ( agent = * child , theme = Emma )
the cake was nursed	nurse ( theme = * cake )
Olivia lent a cake to Emma	lend ( agent = Olivia , theme = cake , recipient = Emma )
Jack slid Emma	slide ( agent = Jack , theme = Emma )
a melon was lent to Olivia	lend ( theme = melon , recipient = Olivia )
Aiden helped a cake	help ( agent = Aiden , theme = cake )
Benjamin gave the toy in a box to Ava	give ( agent = Benjamin , theme = * toy ( nmod . in = box ) , recipient = Ava )
the girl gave the rose to a boy	give ( agent = * girl , theme = * rose , recipient = boy )
Camila smirked	smirk ( agent = Camila )
a raisin was stabbed by Ella	stab ( theme = raisin , agent = Ella )
Isabella gasped	gasp ( agent = Isabella )
the cat appreciated Liam	appreciate ( agent = * cat , theme = Liam )
the potato was found	find ( theme = * potato )
a cookie was handed to Ava	hand ( theme = cookie , recipient = Ava )
Liam rolled a lion beside the computer	roll ( agent = Liam , theme = lion ( nmod . beside = * computer ) )
the boy napped	nap ( agent = * boy )
a child smiled	smile ( agent = child )
a donut was eaten by Emma	eat ( theme = donut , agent = Emma )
a priest snapped the drink beside the stage	snap ( agent = priest , theme = * drink ( nmod . beside = * stage ) )
a donut was cooked by Olivia	cook ( theme = donut , agent = Olivia )
a box was eaten	eat ( theme = box )
Emma sold a girl a cake	sell ( agent = Emma , recipient = girl , theme = cake )
a cake was painted by Scarlett	paint ( theme = cake , agent = Scarlett )
a girl rolled	roll ( theme = girl )
a prince was lent a ball in a house beside a table by a squirrel	lend ( recipient = prince , theme = ball ( nmod . in = house ( nmod . beside = table ) ) , agent = squirrel )
the donut was wired to Harper	wire ( theme = * donut , recipient = Harper )
the purse was given to Emma	give ( theme = * purse , recipient = Emma )
the girl dusted	dust ( agent = * girl )
a baby ate the horse	eat ( agent = baby , theme = * horse )
a girl gave Skylar a cake	give ( agent = girl , recipient = Skylar , theme = cake )
a muffin was lent to Stella by a baby	lend ( theme = muffin , recipient = Stella , agent = baby )
a donut was liked by a cat	like ( theme = donut , agent = cat )
the buyer liked the cat in the cup	like ( agent = * buyer , theme = * cat ( nmod . in = * cup ) )
the cake was lent to a driver by the butterfly	lend ( theme = * cake , recipient = driver , agent = * butterfly )
Carter found the lollipop beside a chair	find ( agent = Carter , theme = * lollipop ( nmod . beside = chair ) )
a cat lent a hammer to Emma	lend ( agent = cat , theme = hammer , recipient = Emma )
Evelyn cooked	cook ( agent = Evelyn )
the cake was tossed by Emma	toss ( theme = * cake , agent = Emma )
a box froze	freeze ( theme = box )
a cookie was nursed by Liam	nurse ( theme = cookie , agent = Liam )
a sweetcorn was given to Aria by Noah	give ( theme = sweetcorn , recipient = Aria , agent = Noah )
Emma fed the girl the cookie	feed ( agent = Emma , recipient = * girl , theme = * cookie )
a rose was touched	touch ( theme = rose )
a girl was given a donut	give ( recipient = girl , theme = donut )
Abigail noticed that Harper proved that a raisin was given to the girl	notice ( agent = Abigail , ccomp = prove ( agent = Harper , ccomp = give ( theme = raisin , recipient = * girl ) ) )
a baby wanted to walk	want ( agent = baby , xcomp = walk ( agent = baby ) )
Emma lent a turkey the melon on a bag	lend ( agent = Emma , recipient = turkey , theme = * melon ( nmod . on = bag ) )
the donut was handed to a monkey	hand ( theme = * donut , recipient = monkey )
Liam slipped the shoe to the boy	slip ( agent = Liam , theme = * shoe , recipient = * boy )
a dog dreamed to sneeze	dream ( agent = dog , xcomp = sneeze ( agent = dog ) )
the baby missed William	miss ( agent = * baby , theme = William )
the sandwich was burned by the girl	burn ( theme = * sandwich , agent = * girl )
a boy hoped that Olivia returned Isabella the cookie	hope ( agent = boy , ccomp = return ( agent = Olivia , recipient = Isabella , theme = * cookie ) )
Emma liked Penelope	like ( agent = Emma , theme = Penelope )
a jacket inflated	inflate ( theme = jacket )
a hat was rolled	roll ( theme = hat )
a donut was crumpled by a girl	crumple ( theme = donut , agent = girl )
a president walked	walk ( agent = president )
a box was given to William	give ( theme = box , recipient = William )
the cake was found by a girl	find ( theme = * cake , agent = girl )
the donut collapsed	collapse ( theme = * donut )
the child investigated the girl	investigate ( agent = * child , theme = * girl )
a boy ate Claire	eat ( agent = boy , theme = Claire )
Evelyn shortened the box	shorten ( agent = Evelyn , theme = * box )
the hammer was cleaned	clean ( theme = * hammer )
a boy meant that James liked a girl	mean ( agent = boy , ccomp = like ( agent = James , theme = girl ) )
Elizabeth rolled	roll ( theme = Elizabeth )
the wine was heard by Emma	hear ( theme = * wine , agent = Emma )
Elijah ate	eat ( agent = Elijah )
a cake was eaten	eat ( theme = cake )
a princess painted the cake	paint ( agent = princess , theme = * cake )
Emma declared that a fish hoped that a donut was painted by the researcher	declare ( agent = Emma , ccomp = hope ( agent = fish , ccomp = paint ( theme = donut , agent = * researcher ) ) )
Emma crumpled Liam	crumple ( agent = Emma , theme = Liam )
a girl inflated	inflate ( theme = girl )
a girl planned to walk	plan ( agent = girl , xcomp = walk ( agent = girl ) )
Emma gave a coin beside the table to David	give ( agent = Emma , theme = coin ( nmod . beside = * table ) , recipient = David )
the cookie was seen	see ( theme = * cookie )
Christopher was given a sweetcorn on the table by Sophia	give ( recipient = Christopher , theme = sweetcorn ( nmod . on = * table ) , agent = Sophia )
a bag was eaten by Abigail	eat ( theme = bag , agent = Abigail )
the boy shortened	shorten ( theme = * boy )
Julian slept	sleep ( agent = Julian )
the hen was given a cake on the table by the girl	give ( recipient = * hen , theme = cake ( nmod . on = * table ) , agent = * girl )
Ava said that a newspaper was rolled by Emma	say ( agent = Ava , ccomp = roll ( theme = newspaper , agent = Emma ) )
